........
.....xx.
.xxx..x.
......x.
..x.x...
..x..xx.
..xx..x.
........
